Jessica you password is: chicago
Jennifer you password is: eric
Andrew you password is: classic
Brandon you password is: cookie
Stephanie you password is: fender
Nicole you password is: raiders
Melissa you password is: marlboro
Steven you password is: spiderman
Thomas you password is: asdfasdf
Timothy you password is: midnight
Kyle you password is: barney
Rachel you password is: hello
Lauren you password is: dragon
Amber you password is: thomas
Danielle you password is: crystal
Richard you password is: darkside
Crystal you password is: robert
Michelle you password is: wilson
Tiffany you password is: password
Jeremy you password is: samantha
Benjamin you password is: ranger
Rebecca you password is: charlie
Jacob you password is: richard
Sean you password is: simon
Erin you password is: eugene
Sara you password is: warcraft
Dustin you password is: gandalf
Angela you password is: football
Scott you password is: hockey
Travis you password is: phpbb
Lisa you password is: brandy
Kenneth you password is: qwerty
Bryan you password is: spring
Jose you password is: please
Alexander you password is: wolverin